11111111
10010001
10100111
1100N001
11111001
11  1111
11  1111