111111
100011
100N11
10001111111111
111111