111111
11100111111111111111111111111111111
1 1W01                                    
111111