111111
11100111111111111111111111111111111
1 1N01                                    
111111