NO IMG/codam/freek.png
SO IMG/codam/leon.png
WE IMG/codam/job.png
EA IMG/codam/peer.png

F 100,0,0
C 0,0,50

111111111111111111111111111
100000000000000000000000001
100000001110000001111100001
100000110110000010001100001
100001100110000000011000001
100011111111100000110000001
100000000110000011000000001
100000000110000111111000001
100000000000N00000000000001
111111111111111111111111111