NO IMG/Wolfenstein/bluestone.png
SO IMG/Wolfenstein/greystone.png
WE IMG/Wolfenstein/wood.png
EA IMG/Wolfenstein/pillar.png

F 220,100,0
C 225,8,66

111111111
100000001
1011N1101
100000001
111111111