1111111111111
100000011
1000N0011
100000011
111111111111