NO ./path_to_the_north_texture
SO ./path_to_the_south_texture
WE ./path_to_the_west_texture
EA ./path_to_the_east_texture

F 220,100,0
C 225,30,0

1111111111111111111111111
100000000110000000000001
111111111000001110000000000001
1001000000000000000000001
111111111011000001110000111111111
100000000011000001110111111111111
11110111111111011100000010001
11110111111111011101010010001
11000000110101011100000010001
10000000000000001100000010001
10000000000000000101010010001
110000011101010101010110N0111
111101111110101100011010001
111111111111111111111111111