1111111111111111111111111
1000000001100000000000011
1111111110000011100000001
1001000000000000X000001111
11111111101100000111000011111111111111111
100000000011000001110111111111111
111101111111110111110000010011
111101111111110101 1010100101
11000000110101011111000010001
10000000000000001100000010001
10000000000000000101010011101
110000011101010101010110W0111
111101111110101100011010001
111111111111111111111111111