1111111111111111111111111
1000000001100000000000011
1111111110000011100000001
1001000000000000000000001
111111111011000001110000111111111
100000000011000001110111111111111
11110111111111011100000010001
11110111111111011101010010001
11000000110101011100000010001
10000000000000001100000010001
10000000000000000101010011101
110000011101010101010110N0111
111101111110101100011010001
111111111111111111111111111
