
       NO IMG/SUPER/grains.png
    SO IMG/SUPER/seafood.png
WE IMG/SUPER/ramen.png
    EA IMG/SUPER/leon-milk.png


C 125,   222,100
F  80,175,232


   111111111111111111111
   100000000110000000001
111111111000001110000001
1001000000000000000000011
111111111011000001110000111111111
100000000011000001110111111111111
11110111111111011100000010001
11110111111111011101010010001
11000000110101011100000010001
10000000000000001100000010001
10000000000000000101010010001
110000011101010101010110N0111
111101111110101100011010001
111111111111111111111111111