1111111111111111111111111
1000000000110000000000001
1011000001110000000000001
1001000000000000000000001
111111111011000001110000111111111
1000000000110000011101111111
1111011111111101110000000001
11110111111111011101010010001
11000000110101011100000010001
10000000000000001100000010001
10000000000000001101010010001
11000001110101010101011110N0111111
1111011111101000000010001111
111111111111111111111111111