NO IMG/SUPER/grains.png
SO IMG/SUPER/seafood.png
EA IMG/SUPER/leon-milk.png
WE IMG/SUPER/ramen.png

C 125,222,100
F 8,175,232

111111111111111111111111
100000000110000000000001
111111111000001110000001
100100000000000W000000011
111111111011000001110000111111111
100000000011000001110111111111111
11110111111111011100000010001
11110111111111011101010010001
11000000110101011100000010001
10000000000000011000000100011
10000000000000000101010010001
11000001110101010101011000111
111101111110101100011010001
111111111111111111111111111